111111111111111111111111111111111111111111111111111111111111111111111111111
11000100001C000000000010000000C01001000000C000010D000100D000000000000100101
10000000000D000000000100000D0000001000D0C000100C10C0000000C0100D00001000111
10000100100000000000000100D0C000101110001000000C00000000000000C000100010001
100C00000C00000D0000000010C000000000000000000010000100C10000000010000000001
10001D0000001000001000000000000000000000000001000000000010C0000000000000001
10C00100000000000000000000C000C10000D0001C00000000100000001000000011E0C0C01
10000000000C0000001CC001000001000C001101C000011C0101010011000D1D0001CC01001
1C0000000000000001100001100001000000000000000010000000000000010100000001C01
1000000000000000001000000C000000011000000000000100000000000000001C01C010D01
100010D0010000C0C000000110000000010000000000C0D00000100001000C0000000000001
100000000001000C0D0C0C000000000000000000000000001000000000000000D1000000001
110100C01100000000000000C0000000000D00100C1000010D0000010000010000100C00001
100CC0000C000000CC0000000000000000010000000110C00000000100D00000000C0000C11
10000000111000000D0C0010000000000000000000000100000000000000000000011000001
10C000D00101000000000000000110000010001C00000000000000000000010010000C0CC01
1C000001100C000D0C0000000C00001C0D00C00C00C00001000000000D00000000000000001
1C0000001C0001001000000000000000000C011001000010000010001000010010001010C11
1000000C000000000000000000000C00000D00C0001000000000C0000000000000C00000C01
1000000000000000000000000010110000C1010C0000000000000000C000000D11D0001D001
10010000000C00C00D111C000000000000000000C00000000000000000000000D0000000001
1011000011D000010000001001000000000000000000D0C0000010011000010000C11000001
111000000000000C0000000000000010000C000000000000000000000000110000C00010001
10001000000000000100C0000000000D10100000000000100CC0000D0000000001000010001
10C100001000000000000001000000101100000000100C0000C0000000100000C0000100001
100000000000C00000000010D001C000000000001000000000000000100D0001C0C00000001
1001000000001000D00000000C00C01D000100010000000000000000000000000C1010CC001
100010000000101000000D000C00000D000000D0000C00000001100000000D0000010000011
1101000C10100000100000000000000C0101000000001C0000C000000001000000001CC0001
10000000001000C010000000C0000C0C10100000C01010D0000001000000000000000000001
110C0000000C000D000000000C00100D00000011000001110000000CD000000000D01100001
1000000D00000001000000000000000100000010000100001000000000000C0000000000001
1000000CC000000000100000000000000001000010000010000000C0000000000C000C00001
10000000010000C0DCD0000000000000000000000C0C00001000C00000001C010000000C001
1C00000000010001D00000C00010100000D0C00000101100000000C111000000000C0001101
1000000000000001000000C0C01000000000000010010000010100000000000000D01C00001
10100001000000C010010100C0100010D0D0010001000001000100000C000000000D1000001
10C000001000000C0100000000011100D000000000000000000001000C000110000001D1001
1100010000000001100D0011000C0C00000C00000000000001000C100000000100000000001
100000001C0C000001100000000C0000000001C000000000000000000000000000010000001
10001001000000000000000000000C000000000000000001D0011001000000C000000000001
1D000C100000000000100010010100000000C1000C010001001C00000000D00D00000000011
1001000C0000001000C0000C0000D0010000000DC01C0000000010000000000000000000001
1000000000000000000000D0000000000000000101000000000DD00000000010001010C0001
100000000100000D0000000000C000000000000000C0000000000C0100000000010000000C1
11000C001000000000001000000000100001000D0000D00000001001C000000000000000001
100001000000100000000000C000000000D0000000C0C00000D01000C001000000010000001
11100100100001000000C000001010101100000000000000000000C0000010C000000001001
100000010D001C0001010C000000000000100100000C000000000100000100000000P00CC11
111111111111111111111111111111111111111111111111111111111111111111111111111