111111111111
10D1000000C1
100001111101
1P0011E00001
1000C1111101
10011111C001
1000C1111101
1C11111C0001
111111111111
