111111111111
1001000000C1
10D001111101
1P0011E00001
1000C1111101
10011111C001
1000C1111101
1C11111C0001
111111111111
